**Notes: Config dotfiles at https://github.com/P217F/nvim-dots.git**
All keymap of this dotfiles is on vim-command, type :NvCheatsheet to see.

- Keymap default by vim/neovim(normal mode)
daw: delete a word in pointer(delete space)
di(: delete all in (*)
w: move to next word
e: move to end of word
O: Push present line to down and create new line(not delete)
s: delete an char in pointer and go to insert mode
S: delete all in line and go to insert mode
dd: delete a line
<Shift> + > + >: indent line(can use in visual mode to indent many line)
<Shift> + < + <: unindent line(can use in visual mode to unindent many line)
gh: go to select mode
v: go to visual mode
V: go to visual mode, wrap all in line
a: insert mode after char
A: insert mode at end of line
i: insert mode
I: insert mode in begin of line
/: go to find mode
n/N: go to next/previous word that you highlight in find mode
x: delete a char
dw: delete word after pointer(ignore space)
d$: delete to end of line
cw: change word
ciw: change word
c$: edit to end of line
cc: edit all line
yy: yank line
yiw: copy word
y$: copy to end of line
p/P: paste to after/before line

